25 25 120
1 1 1 1 1 1 1 1 1 1 1 1 1 1 1 1 1 1 1 1 1 1 1 1 1
1 0 0 5 1 0 0 0 0 0 0 0 1 0 0 0 0 0 0 0 0 0 0 0 1
1 0 1 1 1 1 1 1 1 1 1 0 1 0 0 0 0 0 1 0 0 0 0 0 1
1 0 0 0 0 0 0 0 0 0 1 0 1 0 1 1 1 1 1 1 1 1 1 0 1
1 1 1 0 1 1 1 1 1 0 1 0 1 0 0 0 0 0 0 4 0 0 1 0 1
1 0 1 0 0 0 1 1 0 0 1 0 1 1 1 0 1 1 1 1 1 0 1 0 1
1 0 1 4 1 1 1 1 1 0 1 0 1 0 0 0 0 1 0 1 0 0 0 0 1
1 0 1 0 0 0 1 1 0 1 1 0 1 0 0 0 1 0 1 1 0 1 0 0 1
1 0 1 0 1 1 1 1 1 0 1 0 1 0 4 1 0 1 0 1 1 0 0 0 1
1 0 1 0 0 0 0 0 0 0 1 0 1 1 0 0 1 0 1 1 0 1 0 0 1
1 0 1 1 1 1 1 1 1 0 1 0 1 1 0 1 0 1 0 1 0 0 1 0 1
1 0 0 0 0 0 0 4 0 0 0 0 0 0 0 1 0 0 0 4 0 0 0 0 1
1 1 1 1 1 1 1 1 1 1 1 1 1 1 1 1 0 1 1 1 1 1 1 1 1
1 0 0 0 0 0 0 0 0 0 0 0 1 0 0 0 0 0 0 0 0 0 0 0 1
1 0 0 0 0 0 1 0 0 0 0 0 1 0 4 0 0 0 0 0 0 0 0 0 1
1 0 0 0 0 0 1 0 0 0 0 0 1 0 0 0 0 1 0 1 0 0 0 0 1
1 0 1 0 1 1 1 1 1 1 1 0 1 0 0 0 1 0 0 1 0 1 0 0 1
1 0 1 0 4 0 0 0 0 0 1 0 1 1 1 1 0 1 0 1 1 0 0 0 1
1 0 1 0 0 0 1 0 0 0 1 0 1 0 0 0 0 1 0 1 1 1 1 0 1
1 0 1 1 1 1 1 1 0 1 1 1 1 0 0 0 0 0 1 0 0 0 0 0 1
1 0 0 0 0 0 1 0 0 0 0 0 0 0 0 1 1 1 1 1 1 1 0 0 1
1 0 4 0 0 0 1 0 0 0 0 0 1 0 0 0 0 0 1 0 0 0 0 0 1
1 2 0 0 0 0 1 0 0 0 0 0 1 0 0 0 0 0 1 0 0 0 0 0 1
1 3 0 0 0 0 1 0 0 0 0 0 1 0 0 4 0 0 0 0 0 0 0 0 1
1 1 1 1 1 1 1 1 1 1 1 1 1 1 1 1 1 1 1 1 1 1 1 1 1
9
4 19 2
6 3 0
8 14 0
11 7 2
11 19 2
14 14 2
17 4 2
21 2 2
23 15 2