25 25 100
1 1 1 1 1 1 1 1 1 1 1 1 1 1 1 1 1 1 1 1 1 1 1 1 1
1 0 0 0 0 1 0 0 0 0 0 0 1 0 0 0 0 4 0 0 0 0 0 0 1
1 0 0 0 0 1 0 0 0 0 0 0 1 0 1 1 1 0 0 0 0 1 0 0 1
1 0 0 0 1 1 1 0 0 0 0 4 1 0 0 0 1 0 0 0 1 1 1 0 1
1 0 0 1 0 1 0 0 0 0 0 0 1 1 1 0 1 0 0 1 1 1 0 0 1
1 0 0 1 0 0 0 0 0 0 4 0 1 0 0 0 0 1 0 1 1 0 0 0 1
1 0 4 0 0 1 1 0 0 4 0 0 1 0 0 4 0 1 1 1 0 0 0 0 1
1 0 0 0 0 1 0 1 0 0 0 0 0 0 0 0 1 1 1 0 0 0 0 0 1
1 0 0 1 0 1 0 1 0 0 0 0 1 0 0 1 1 1 0 0 1 1 1 0 1
1 0 0 0 1 1 1 0 0 0 0 0 1 0 1 1 1 0 4 0 1 0 1 1 1
1 0 0 0 0 1 0 0 0 0 0 0 1 1 1 1 0 0 0 0 1 1 1 0 1
1 0 0 0 0 0 1 0 0 0 0 0 1 0 0 0 0 0 4 0 0 0 0 0 1
1 1 0 1 1 1 1 1 1 1 1 1 1 1 1 0 1 1 1 1 1 1 1 1 1
1 0 0 0 1 0 0 0 0 0 0 0 1 0 0 0 0 4 0 0 0 0 0 0 1
1 0 0 0 1 1 1 0 0 0 0 0 1 0 0 0 0 1 0 0 0 1 0 0 1
1 0 0 1 0 0 0 1 0 0 0 0 1 0 0 0 1 0 0 0 1 0 0 0 1
1 0 0 0 0 4 0 1 0 0 0 0 1 1 1 1 1 1 1 1 1 1 1 0 1
1 0 0 1 0 0 0 0 0 1 0 0 1 0 0 0 1 0 0 0 1 0 0 0 1
1 0 4 1 1 1 0 0 0 1 0 0 1 0 0 0 0 4 0 0 0 0 0 4 1
1 0 1 0 0 0 0 0 1 0 0 0 1 0 0 0 1 0 0 0 1 0 0 0 1
1 0 1 0 4 0 0 1 0 0 0 0 1 0 1 1 1 1 1 1 1 1 1 0 1
1 4 1 0 0 0 1 0 1 0 0 0 1 4 0 0 1 0 2 5 1 0 0 0 1
1 0 0 1 0 1 0 0 0 1 1 1 1 0 0 1 0 0 0 1 0 0 0 0 1
1 0 0 0 4 0 0 0 0 0 0 0 1 0 0 4 0 0 0 1 0 0 0 0 1
1 1 1 1 1 1 1 1 1 1 1 3 1 1 1 1 1 1 1 1 1 1 1 1 1
18
1 17 2
3 11 0
5 10 0
6 2 2
6 9 0
6 15 2
9 18 0
11 18 2
13 17 2
16 5 0
18 2 2
18 17 0
18 23 0
20 4 0
21 1 0
21 13 0
23 4 2
23 15 2